#1
50,-1
7,8,7,8,7,7,8,8,0,0,-1
#2
95,1/40,1/15,-1
5,2,7,4,6,8,1,2,3,4,1,2,3,4,3,3,8,0,5,5,1,4,0,4,0,7,6,8,2,0,1,7,6,4,2,1,8,7,3,2,5,1,2,0,3,1,6,2,4,5,0,7,1,8,0,5,4,0,5,1,3,6,5,0,4,1,3,2,1,4,7,2,8,1,8,2,6,3,5,0,4,1,5,2,3,6,7,4,0,1,5,6,2,4,1,0,0,0,0,-1
#3
30,-1
0,0,1,2,3,4,5,6,7,8,0,1,2,3,4,5,6,7,8,0,1,2,3,4,5,6,7,8,0,1,2,3,4,5,6,7,8,0,1,0,0,0,-1
#4
10,-1
5,0,0,0,0,0,0,0,0,0,0,0,0,0,6,5,5,6,6,5,5,5,5,6,6,6,6,5,5,6,5,6,6,6,6,5,5,5,5,6,6,6,6,5,6,5,6,0,0,0,0,-1
#5
10,-1
1,2,3,4,1,2,3,4,2,1,3,4,2,4,3,1,2,4,1,1,2,3,4,1,3,1,1,2,1,4,3,1,4,2,1,3,1,1,3,1,2,3,2,2,2,4,3,5,4,4,0,0,0,0,-1
#6
50,-1
4,4,0,5,6,7,0,0,0,0,-1
#7
60,-1/40,1/15,-1
5,6,5,5,6,5,1,2,3,4,1,2,3,4,3,3,8,0,5,5,1,4,0,4,0,7,6,8,2,0,1,7,6,4,2,1,8,7,3,2,5,1,2,0,3,1,6,2,4,5,0,7,1,8,0,5,4,0,5,1,3,6,5,0,4,1,3,2,1,4,7,2,8,1,8,2,6,3,5,0,4,1,5,2,3,6,7,4,0,1,5,6,2,4,1,0,0,0,0,-1
#8
30,-1
0,0,1,2,3,4,5,6,7,8,0,1,2,3,4,5,6,7,8,0,1,2,3,4,5,6,7,8,0,1,2,3,4,5,6,7,8,0,1,0,0,0,-1
#9
10,-1
0,5,5,5,6,6,6,5,6,5,6,5,6,5,6,5,5,6,6,5,5,5,5,6,6,6,6,5,5,6,5,6,6,6,6,5,5,5,5,6,6,6,6,5,6,5,6,0,0,0,0,-1
#10
10,-1
1,2,3,4,1,2,3,4,2,1,3,4,2,4,3,1,2,4,1,1,2,3,4,1,3,1,1,2,1,4,3,1,4,2,1,3,1,1,3,1,2,3,2,2,2,4,3,5,4,4,0,0,0,0,-1
